#A###########################
#   #     #       #     #   #
# # # ### # ##### # ### # # #
# #   #   #     #   #   # # #
# ### # ####### ### # ### # #
#   # #     #     # #   #   #
### # ##### # ##### # # #####
#   #     # #     # # #     #
# ####### # # ### # # #######
#       #   #   # # #   #   #
##### # ##### # # # ### # # #
#   # #     # #   #   # # # #
# # ####### # ##### ### # # #
# #     #   #     #   #   # #
# ##### # ####### # # ### ###
#     # #       # # #   #   #
##### # ####### # # ### # ###
#   #   #     #   #   # #   #
# # ##### ### ##### ### # # #
###########################B#